111111
1PCC01
100C01
100111
101C01
1E1C01
111111