11111111111111111111111111111
11MMMMMMMMMMMMMM1111111111111
1P111111111111111111111111111
1E1111111M1111011111111111001
10011111111111011111111111001
1C111111111111111111111111111
11111111111111111111111111111