111111
1P00C1
100001
110001
1E1101
10CC01
111111