111111
10MCM1
100C01
100001
101111
1EP1C1
111111