111111
10MCM1
10PC01
100001
110101
1E00C1
111111