1111111111111111
1C01E10000000001
1C011100000000C1
10C000000P0000C1
1111111111111111