11111111111
10000000001
10000110001
10000E1P1C1
11111111111