11111111111
1P000000001
11100100111
1C101EC00C1
11111111111