111111111111111
100001001010011
100010000000011
1E1100100001011
1PC000000M01011
100000000100001
100001010100011
100000000000011
100000000001011
100000000000011
111111111111111