111111
10MCM1
10PC01
100101
100111
1E0C01
111111