1111111111
1MCCCC1CM1
101CCC1C01
10111C0101
1PCC0C0001
1000000001
1C00000E01
1111111111