111111
10MCM1
100C01
100001
101111
1E0PC1
111111