111111
1PCC01
100C01
100101
100011
1E1C01
111111