111111111111111
1MCCC1CC1010C11
10CC1C0C0000011
1E11C01MC001011
1PCC0C0C0001011
100000CC01000C1
1C0001C101C0011
1M00000000M0011
10C0000C0C01011
1C00000C0C00011
111111111111111