111111111111111
1MCCC1CC1010C11
10CC1C0C0000011
1E11C010C001011
1PCC0C0CM001011
100000CC01000C1
1C0001C101CM011
100000000MM0011
1MC0000C0C01011
1C00000C0C00011
111111111111111