1111111111111
1C01E00P00101
1000010101C01
1111111111111