1111111111111111
1C01E10000000001
11010100111000C1
100000000P1000C1
1111111111111111