1111111111111
1C01E00000001
100001P1001C1
1111111111111