1111111111111111111111
1MCCC1CM0C1C0CC1010C11
10CC1C01C0C010C0000011
1E11C0101C0C010C001011
1PCC0C01C0C010C0001011
100000C1C0C010C01000C1
1C0001C0C0101C101C0011
1000000000000000000011
1MC0000000C0C0C0C01011
1C000000C1C0C0C0C00011
1111111111111111111111