111111
10MCM1
10PC01
100011
100001
1E01C1
111111