111111
1PMCM1
100C01
100101
100111
1E0C01
111111