11111111111
1P000000001
11100111101
1C001EC00C1
11111111111