11111111111111111111111111111
1000000000000000111CCCCCCC111
1PCCCCC000000000CCCCC10001111
1E1111111M11110CCCCC110001001
100111111111110CCCCC111111001
1C111100000000000000001111111
11111111111111111111111111111