111111
10MCM1
100C01
100001
101111
1EP0C1
111111
111111
111111
111111
111111
111111